###############################
#p *b*2        *2 ** * *     *#
# # # # #*# # #*# # # # # #*# #
#   f* * *** **      *    **  #
# #*# # # # #1# # #1# # # # #*#
#         1*     **      *  **#
# # #*# # # # # #*#*#*#*# # # #
#   *1       *   * *x* *      #
# # # # #*# # # # # # #*# #*# #
#   ****         *1           #
# # # # # # # # # #*# # # # #*#
#  ** *   *    2              #
###############################